11111111111111
1E1010101011C1
101010101011C1
101000100011C1
100010001000P1
11111111111111