111111111111111
1E1111001101101
100001011000101
111100001010101
101101100010101
100000001010101
110110111111101
110000110000001
110111110110111
110010000010111
111010101010001
100010101010101
101111101010101
1000000010001P1
111111111111111