111111111111111111111111111111111
1E11110011011C0000010100010001001
1000C10110001000C0001010001C00001
1111000010101011000010000C0010001
101101100010100C0001000001C000011
10000000101010001000001000C010001
1101101111111010C0001010001C00001
11000011000C0001C0001010001C00001
110111110110110C0001010001C000011
110010000010111C0001000001C000011
1110101010100001000010000C0010001
11000011000C0001C0001010001C00001
110111110110110C0001010001C000011
110010000010111C0001000001C000011
1110101010100001000010000C0010001
1000101010101010C0001010001C00001
1011111010101011000011000C0010001
10C000001000110C0001000001C0P0001
111111111111111111111111111111111