111111111111111111111111111111111
10000000000000CEP00000000000000E1
111111111111111111111111111111111